S #############
# #     #     #
# ### # ### ###
# #   ##    ###
# ### ## ##  ##
#      # #   ##
# #  ### #  ###
# ##     ##  ##
# ## ###   # ##
# # #######   #
# #     #### ##
##  ####     ##
## ## # ###  ##
##          ###
###########  GF